#############
e..#.#...#..#
##.#.##.##.##
#....#..#...x
###.#~.##.###
#...........#
#####.###.###
#...........#
#############